1111111
1E00001
1011101
1000S01
1111111