1111111111111
1E00100000001
1011101110101
1010001000101
1011101010111
1000101010001
101011Z010101
1010000010101
1011111110101
1111111111111