111111111111111111111
1E1000100000000000001
101011101111111111101
101010001000000000101
101010111011111011101
101000001000001010001
101111101110111010101
100000101000100010101
111110101111101110101
101000100000101000101
101011111110101011101
101000001000001010101
101111101111111010101
100000100010000010101
101110111010111110101
100010100010000010001
111110101111111011111
100000100000001000001
101111111111101111101
100000000000100000101
101111111110111110101
101000100010001000101
101010101011101011101
1000100010001000000S1
111111111111111111111