111111111111111
1E0010000000001
101110111010101
101000010000101
101111011010111
100010010010001
101011110111101
101000010010101
1011110001101S1
111111111111111