1111111
1E00001
1000101
1000S01
1101111